111111111111111111111111111111111111111111111111111111111
1E0000000000000C000000111100010111110000C0000000000000001
101000000000001010010000000101001000000000000000000010101
101001001010101000100100000111000000000000010001000010101
100000000100000C00C000000000000110000000010000001000100C1
1P0000C110000001011101101010000000000101000000101000100C1
101000000000001010010000000101001000000000000000000010101
111111111111111111111111111111111111111111111111111111111